0,550,50,50,0,0,16,16,1
0,500,50,50,0,0,16,16,1
50,550,50,50,0,0,16,16,1
50,500,50,50,0,0,16,16,1
100,550,50,50,0,0,16,16,1
100,500,50,50,0,0,16,16,1
250,550,50,50,0,0,16,16,1
250,500,50,50,0,0,16,16,1
300,550,50,50,0,0,16,16,1
300,500,50,50,0,0,16,16,1
450,550,50,50,0,0,16,16,1
450,500,50,50,0,0,16,16,1
500,550,50,50,0,0,16,16,1
500,500,50,50,0,0,16,16,1
550,550,50,50,0,0,16,16,1
550,500,50,50,0,0,16,16,1
600,550,50,50,0,0,16,16,1
600,500,50,50,0,0,16,16,1
700,550,50,50,0,0,16,16,1
700,500,50,50,0,0,16,16,1
750,550,50,50,0,0,16,16,1
750,500,50,50,0,0,16,16,1

400,400,100,30,184,144,32,16,0
550,350,100,30,184,144,32,16,0
700,300,100,30,184,144,32,16,0

300,400,50,50,16,0,16,16,1
500,350,50,50,32,0,16,16,1
620,250,50,50,32,0,16,16,1

800,500,50,100,0,129,32,31,1
1000,500,50,150,0,129,32,31,1

150,100,100,70,88,320,32,24,0
850,80,100,70,88,320,32,24,0

1150,175,10,350,263,240,2,25,1,flag
1152,175,50,50,196,330,14,15,1,flag

1100,350,100,30,184,144,32,16,0

enemy,420,500,400,500,2
enemy,680,500,650,700,3

